#E######################################
# ###################                  #
# #########         # ################ #
# ######### ####### # ########### #### #
#      #### ####### #             #### #
###### #### ####### ############# #### #
###### #### ####### ############# #### #
###### #### ####### #             #### #
######      ####### ############# #### #
###################               #### #
######################################S#